1, 6, 6, 6, 6, 2, 2, 2, 2, 2, 2, 2, 5, 6, 6, 1
1, 6, 3, 3, 3, 3, 3, 3, 3, 3, 3, 3, 3, 3, 6, 2
1, 6, 3, 4, 4, 4, 4, 4, 4, 4, 4, 4, 4, 3, 3, 2
1, 2, 3, 4, 7, 4, 4, 4, 4, 4, 4, 4, 4, 4, 3, 2
1, 5, 3, 4, 4, 4, 4, 4, 4, 4, 5, 5, 4, 4, 3, 2
1, 2, 3, 4, 4, 4, 4, 4, 4, 4, 5, 3, 3, 3, 3, 5
1, 2, 3, 3, 4, 4, 4, 4, 4, 4, 4, 3, 7, 7, 2, 1
1, 2, 5, 2, 3, 3, 3, 4, 4, 3, 3, 3, 2, 2, 2, 1
