1, 2, 2, 2, 2, 2, 5, 4, 5, 2, 2, 2, 2, 2, 2, 1
1, 2, 7, 7, 3, 3, 3, 4, 3, 3, 3, 6, 6, 6, 6, 1
1, 6, 3, 3, 3, 4, 4, 4, 4, 4, 3, 3, 3, 3, 6, 1
1, 2, 3, 4, 3, 4, 4, 4, 4, 4, 3, 4, 4, 3, 2, 1
1, 2, 3, 4, 4, 4, 4, 4, 4, 4, 4, 4, 4, 3, 2, 1
1, 2, 3, 4, 4, 4, 4, 4, 4, 3, 3, 3, 3, 3, 2, 1
1, 7, 3, 3, 3, 3, 3, 3, 3, 3, 7, 7, 7, 2, 2, 1
1, 7, 7, 2, 2, 2, 2, 2, 7, 7, 2, 2, 2, 2, 2, 1
